Christopher	Bond
Robert	Grimes
Kelly	Petersen
Joseph	Caldwell
Frank	Williams
Carrie	Simpson
April	Weeks
Ronald	Davis
Corey	Rivera
Felicia	White
Robert	Casey
Adam	Scott
Darrell	Moore
Joseph	Kelly
Jordan	Carlson
Tammy	Jones
James	Moore
Thomas	Malone
Pamela	Russell
Craig	Mckenzie